[
  {
    "type": "mapgen",
    "method": "json",
    "om_terrain": [
      [ "hollow_village1", "hollow_village2", "hollow_village3" ],
      [ "hollow_village4", "hollow_village5", "hollow_village6" ],
      [ "hollow_village7", "hollow_village8", "hollow_village9" ]
    ],
    "object": {
      "fill_ter": "t_dirt",
      "rows": [
        "........................................................................",
        "........................................................................",
        "........................................................................",
        "........................................................................",
        "........................................................................",
        "........................................................................",
        "........................................................................",
        "........................................................................",
        "........................................................................",
        "........................................................................",
        "........................................................................",
        "........................................................................",
        "........................................................................",
        "........................................................................",
        "........................................................................",
        "........................................................................",
        "........................................................................",
        "........................................................................",
        "........................................................................",
        "........................................................................",
        "........................................................................",
        "........................................................................",
        "........................................................................",
        "........................................................................",
        "........................111111111111111111111111........................",
        "........................1......................1........................",
        "........................1......................1........................",
        "........................1......................1........................",
        "........................1......................1........................",
        "........................1......................1........................",
        "........................1......................1........................",
        "........................1......................1........................",
        "........................1......................1........................",
        "........................1......................1........................",
        "........................1......................1........................",
        "........................1......................1........................",
        "........................1......................1........................",
        "........................1......................1........................",
        "........................1......................1........................",
        "........................1......................1........................",
        "........................1......................1........................",
        "........................1......................1........................",
        "........................1......................1........................",
        "........................1......................1........................",
        "........................1......................1........................",
        "........................1......................1........................",
        "........................1......................1........................",
        "........................1111111111...11111111111........................",
        "..................................___...................................",
        ".........................------...___...................................",
        ".........................|B##B|...___...................................",
        ".........................|=###|..._._...................................",
        ".........................|=#o#3.._._....................................",
        ".........................|=###|..___....................................",
        ".........................|B##=|....__...................................",
        ".........................------..___....................................",
        "..................................__....................................",
        "................................._._....................................",
        "........................................................................",
        "........................................................................",
        "........................................................................",
        "........................................................................",
        "........................................................................",
        "........................................................................",
        "........................................................................",
        "........................................................................",
        "........................................................................",
        "........................................................................",
        "........................................................................",
        "........................................................................",
        "........................................................................",
        "........................................................................"
      ],
      "palettes": [ "hollow_village_palette" ],
      "place_nested": [ { "chunks": [ "hollow_village_interior" ], "x": 24, "y": 24 } ]
    }
  },
  {
    "type": "overmap_special",
    "id": "hollow_village",
    "overmaps": [
      { "point": [ 0, 0, 0 ], "overmap": "hollow_village1_north" },
      { "point": [ 1, 0, 0 ], "overmap": "hollow_village2_north" },
      { "point": [ 2, 0, 0 ], "overmap": "hollow_village3_north" },
      { "point": [ 0, 1, 0 ], "overmap": "hollow_village4_north" },
      { "point": [ 1, 1, 0 ], "overmap": "hollow_village5_north" },
      { "point": [ 2, 1, 0 ], "overmap": "hollow_village6_north" },
      { "point": [ 0, 2, 0 ], "overmap": "hollow_village7_north" },
      {
        "point": [ 1, 2, 0 ],
        "overmap": "hollow_village8_north",
        "locations": [ "forest_edge", "field", "lake_shore" ]
      },
      { "point": [ 2, 2, 0 ], "overmap": "hollow_village9_north" }
    ],
    "locations": [ "wilderness" ],
    "city_distance": [ 20, -5 ],
    "city_sizes": [ 0, 13 ],
    "occurrences": [ 0, 1 ],
    "spawns": { "group": "GROUP_HOLLOW_TRIBAL_WARPARTY", "population": [ 2, 6 ], "radius": [ 2, 10 ] }
  },
  {
    "type": "overmap_terrain",
    "id": [
      "hollow_village1",
      "hollow_village2",
      "hollow_village3",
      "hollow_village4",
      "hollow_village5",
      "hollow_village6",
      "hollow_village7",
      "hollow_village8",
      "hollow_village9"
    ],
    "name": "small village",
    "sym": "v",
    "color": "red",
    "see_cost": 6,
    "flags": [ "RISK_HIGH" ]
  }
]
