[
  {
    "type": "mapgen",
    "method": "json",
    "om_terrain": [
      [ "hollow_village1", "hollow_village2", "hollow_village3" ],
      [ "hollow_village4", "hollow_village5", "hollow_village6" ],
      [ "hollow_village7", "hollow_village8", "hollow_village9" ]
    ],
    "object": {
      "fill_ter": "t_dirt",
      "rows": [
        "%%%%%%%%%%%%%%%%%%%%%%%%%%%%%%%%%%%%%%%%%%%%%%%%%%%%%%%%%%%%%%%%%%%%%%%%",
        ",,,,,,,,,,,,,,,,,,,,,,,,,,,,,,,,,,,,,,,,,,,,,,,,,,,,,,,,,,,,,,,,,,,,,,,,",
        "%%%%%%%%%%%%%%%%%%%%%%%%%%%%%%%%%%%%%%%%%%%%%%%%%%%%%%%%%%%%%%%%%%%%%%%%",
        ",,,,,,,,,,,,,,,,,,,,,,,,,,,,,,,,,,,,,,,,,,,,,,,,,,,,,,,,,,,,,,,,,,,,,,,,",
        "%%%%%%%%%%%%%%%%%%%%%%%%%%%%%%%%%%%%%%%%%%%%%%%%%%%%%%%%%%%%%%%%%%%%%%%%",
        ",,,,,,,,,,,,,,,,,,,,,,,,,,,,,,,,,,,,,,,,,,,,,,,,,,,,,,,,,,,,,,,,,,,,,,,,",
        "%%%%%%%%%%%%%%%%%%%%%%%%%%%%%%%%%%%%%%%%%%%%%%%%%%%%%%%%%%%%%%%%%%%%%%%%",
        ",,,,,,,,,,,,,,,,,,,,,,,,,,,,,,,,,,,,,,,,,,,,,,,,,,,,,,,,,,,,,,,,,,,,,,,,",
        "%%%%%%%%%%%%%%%%%%%%%%%%%%%%%%%%%%%%%%%%%%%%%%%%%%%%%%%%%%%%%%%%%%%%%%%%",
        ",,,,,,,,,,,,,,,,,,,,,,,,,,,,,,,,,,,,,,,,,,,,,,,,,,,,,,,,,,,,,,,,,,,,,,,,",
        "%%%%%%%%%%%%%%%%%%%%%%%%%%%%%%%%%%%%%%%%%%%%%%%%%%%%%%%%%%%%%%%%%%%%%%%%",
        ",,,,,,,,,,,,,,,,,,,,,,,,,,,,,,,,,,,,,,,,,,,,,,,,,,,,,,,,,,,,,,,,,,,,,,,,",
        "%%%%%%%%%%%%%%%%%%%%%%%%%%%%%%%%%%%%%%%%%%%%%%%%%%%%%%%%%%%%%%%%%%%%%%%%",
        ",,,,,,,,,,,,,,,,,,,,,,,,,,,,,,,,,,,,,,,,,,,,,,,,,,,,,,,,,,,,,,,,,,,,,,,,",
        "%%%%%%%%%%%%%%%%%%%%%%%%%%%%%%%%%%%%%%%%%%%%%%%%%%%%%%%%%%%%%%%%%%%%%%%%",
        ",,,,,,,,,,,,,,,,,,,,,,,,,,,,,,,,,,,,,,,,,,,,,,,,,,,,,,,,,,,,,,,,,,,,,,,,",
        "%%%%%%%%%%%%%%%%%%%%%%%%%%%%%%%%%%%%%%%%%%%%%%%%%%%%%%%%%%%%%%%%%%%%%%%%",
        ",,,,,,,,,,,,,,,,,,,,,,,,,,,,,,,,,,,,,,,,,,,,,,,,,,,,,,,,,,,,,,,,,,,,,,,,",
        "%%%%%%%%%%%%%%%%%%%%%%%%%%%%%%%%%%%%%%%%%%%%%%%%%%%%%%%%%%%%%%%%%%%%%%%%",
        ",,,,,,,,,,,,,,,,,,,,,,,,,,,,,,,,,,,,,,,,,,,,,,,,,,,,,,,,,,,,,,,,,,,,,,,,",
        "%%%%%%%%%%%%%%%%%%%%%%%%%%%%%%%%%%%%%%%%%%%%%%%%%%%%%%%%%%%%%%%%%%%%%%%%",
        ",,,,,,,,,,,,,,,,,,,,,,,,,,,,,,,,,,,,,,,,,,,,,,,,,,,,,,,,,,,,,,,,,,,,,,,,",
        "%%%%%%%%%%%%%%%%%%%%%%%%%%%%%%%%%%%%%%%%%%%%%%%%%%%%%%%%%%%%%%%%%%%%%%%%",
        "________________________________________________________________________",
        "%,%,%,%,%,%,%,%,%,%,%,%_111111111111111111111111_----__♣♣,♣♣,♣♣,♣♣,♣♣,♣♣",
        "%,%,%,%,%,%,%,%,%,%,%,%_1......................1_|+#|__♣♣,♣♣,♣♣,♣♣,♣♣,♣♣",
        "%,%,%,%,%,%,%,%,%,%,%,%_1......................1_|+#3__♣♣,♣♣,♣♣,♣♣,♣♣,♣♣",
        "%,%,%,%,%,%,%,%,%,%,%,%_1......................1_|+#|__♣♣,♣♣,♣♣,♣♣,♣♣,♣♣",
        "%,%,%,%,%,%,%,%,%,%,%,%_1......................1_----__♣♣,♣♣,♣♣,♣♣,♣♣,♣♣",
        "%,%,%,%,%,%,%,%,%,%,%,%_1......................_________________________",
        "%,%,%,%,%,%,%,%,%,%,%,%_1......................1_%,%,%,%,%,%,%,%,%,%,%,%",
        "%,%,%,%,%,%,%,%,%,%,%,%_1......................1_%,%,%,%,%,%,%,%,%,%,%,%",
        "%,%,%,%,%,%,%,%,%,%,%,%_1......................1_%,%,%,%,%,%,%,%,%,%,%,%",
        "%,%,%,%,%,%,%,%,%,%,%,%_1......................1_%,%,%,%,%,%,%,%,%,%,%,%",
        "%,%,%,%,%,%,%,%,%,%,%,%_1......................1_%,%,%,%,%,%,%,%,%,%,%,%",
        "%,%,%,%,%,%,%,%,%,%,%,%_1......................1_%,%,%,%,%,%,%,%,%,%,%,%",
        "%,%,%,%,%,%,%,%,%,%,%,%_1......................1_%,%,%,%,%,%,%,%,%,%,%,%",
        "%,%,%,%,%,%,%,%,%,%,%,%_1......................1_%,%,%,%,%,%,%,%,%,%,%,%",
        "%,%,%,%,%,%,%,%,%,%,%,%_1......................1_%,%,%,%,%,%,%,%,%,%,%,%",
        "%,%,%,%,%,%,%,%,%,%,%,%_1......................1_%,%,%,%,%,%,%,%,%,%,%,%",
        "%,%,%,%,%,%,%,%,%,%,%,%_1......................1_%,%,%,%,%,%,%,%,%,%,%,%",
        "%,%,%,%,%,%,%,%,%,%,%,%_1......................1_%,%,%,%,%,%,%,%,%,%,%,%",
        "%,%,%,%,%,%,%,%,%,%,%,%_1......................1_%,%,%,%,%,%,%,%,%,%,%,%",
        "%,%,%,%,%,%,%,%,%,%,%,%_1......................1_%,%,%,%,%,%,%,%,%,%,%,%",
        "%,%,%,%,%,%,%,%,%,%,%,%_1......................1_%,%,%,%,%,%,%,%,%,%,%,%",
        "%,%,%,%,%,%,%,%,%,%,%,%_1......................1_%,%,%,%,%,%,%,%,%,%,%,%",
        "%,%,%,%,%,%,%,%,%,%,%,%_1......................1_%,%,%,%,%,%,%,%,%,%,%,%",
        "%,%,%,%,%,%,%,%,%,%,%,%_1111111111...11111111111_%,%,%,%,%,%,%,%,%,%,%,%",
        "%,%,%,%,%,%,%,%_________________________________________________________",
        "%,%,%,%,%,%,%,%___--3--_.------...___________..._ɅɅ,ɅɅ,ɅɅ,ɅɅ,ɅɅ,ɅɅ,ɅɅ,ɅɅ",
        "%,%,%,%,%,%,%,%_W_|###|__|B##B|...___..------..._ɅɅ,ɅɅ,ɅɅ,ɅɅ,ɅɅ,ɅɅ,ɅɅ,ɅɅ",
        "%,%,%,%,%,%,%,%___|+++|__|=###|..._._..|###B|..._ɅɅ,ɅɅ,ɅɅ,ɅɅ,ɅɅ,ɅɅ,ɅɅ,ɅɅ",
        "%,%,%,%,%,%,%,%___-----__|=#o#3___.____3#o#B|..._ɅɅ,ɅɅ,ɅɅ,ɅɅ,ɅɅ,ɅɅ,ɅɅ,ɅɅ",
        "%,%,%,%,%,%,%,%__________|=###|.______.------..._ɅɅ,ɅɅ,ɅɅ,ɅɅ,ɅɅ,ɅɅ,ɅɅ,ɅɅ",
        "%,%,%,%,%,%,%,%_...._....|B##=|....___________.._ɅɅ,ɅɅ,ɅɅ,ɅɅ,ɅɅ,ɅɅ,ɅɅ,ɅɅ",
        "________________.._......------..___.......______ɅɅ,ɅɅ,ɅɅ,ɅɅ,ɅɅ,ɅɅ,ɅɅ,ɅɅ",
        "ɅɅ,ɅɅ,ɅɅ,ɅɅ,ɅɅ_____._____________.__......______________________________",
        "ɅɅ,ɅɅ,ɅɅ,ɅɅ,ɅɅ_♣♣,♣♣,♣♣,♣♣,♣♣_..._._._.____t__...--3-----_%%%%%%%%%%%%%%",
        "ɅɅ,ɅɅ,ɅɅ,ɅɅ,ɅɅ_♣♣,♣♣,♣♣,♣♣,♣♣_.__...______tOt_...|####B=|_,,,,,,,,,,,,,,",
        "ɅɅ,ɅɅ,ɅɅ,ɅɅ,ɅɅ_♣♣,♣♣,♣♣,♣♣,♣♣__._.......___t__...|##o##=|_%%%%%%%%%%%%%%",
        "ɅɅ,ɅɅ,ɅɅ,ɅɅ,ɅɅ_♣♣,♣♣,♣♣,♣♣,♣♣_..........._____...|B###B=|_,,,,,,,,,,,,,,",
        "ɅɅ,ɅɅ,ɅɅ,ɅɅ,ɅɅ_♣♣,♣♣,♣♣,♣♣,♣♣_...................--------_%%%%%%%%%%%%%%",
        "ɅɅ,ɅɅ,ɅɅ,ɅɅ,ɅɅ_♣♣,♣♣,♣♣,♣♣,♣♣_..........................._,,,,,,,,,,,,,,",
        "ɅɅ,ɅɅ,ɅɅ,ɅɅ,ɅɅ_♣♣,♣♣,♣♣,♣♣,♣♣_..........................._%%%%%%%%%%%%%%",
        "ɅɅ,ɅɅ,ɅɅ,ɅɅ,ɅɅ________________..........................._______________",
        "_______________...-----------...........................................",
        "♣♣,♣♣,♣♣,♣♣,♣♣_...|.........|...........................................",
        "♣♣,♣♣,♣♣,♣♣,♣♣_...|.........3...........................................",
        "♣♣,♣♣,♣♣,♣♣,♣♣_...|.........|...........................................",
        "♣♣,♣♣,♣♣,♣♣,♣♣_...-----------..........................................",
        "♣♣,♣♣,♣♣,♣♣,♣♣_.........................................................",
        "♣♣,♣♣,♣♣,♣♣,♣♣_........................................................."
      ],
      "palettes": [ "hollow_village_palette" ],
      "place_nested": [ { "chunks": [ "hollow_village_interior" ], "x": 24, "y": 24 } ],
      
    }
  },
  {
    "type": "overmap_special",
    "id": "hollow_village",
    "overmaps": [
      { "point": [ 0, 0, 0 ], "overmap": "hollow_village1_north" },
      { "point": [ 1, 0, 0 ], "overmap": "hollow_village2_north" },
      { "point": [ 2, 0, 0 ], "overmap": "hollow_village3_north" },
      { "point": [ 0, 1, 0 ], "overmap": "hollow_village4_north" },
      { "point": [ 1, 1, 0 ], "overmap": "hollow_village5_north" },
      { "point": [ 2, 1, 0 ], "overmap": "hollow_village6_north" },
      { "point": [ 0, 2, 0 ], "overmap": "hollow_village7_north" },
      {
        "point": [ 1, 2, 0 ],
        "overmap": "hollow_village8_north",
        "locations": [ "forest_edge", "field", "lake_shore" ]
      },
      { "point": [ 2, 2, 0 ], "overmap": "hollow_village9_north" }
    ],
    "locations": [ "wilderness" ],
    "city_distance": [ 20, -5 ],
    "city_sizes": [ 0, 13 ],
    "occurrences": [ 0, 1 ],
    "spawns": { "group": "GROUP_HOLLOW_TRIBAL_WARPARTY", "population": [ 3, 8 ], "radius": [ 2, 10 ] }
  },
  {
    "type": "overmap_terrain",
    "id": [
      "hollow_village1",
      "hollow_village2",
      "hollow_village3",
      "hollow_village4",
      "hollow_village5",
      "hollow_village6",
      "hollow_village7",
      "hollow_village8",
      "hollow_village9"
    ],
    "name": "small village",
    "sym": "v",
    "color": "red",
    "see_cost": 6,
    "flags": [ "RISK_HIGH" ]
  }
]
