[
  {
    "type": "palette",
    "id": "hollow_village_palette",
    "terrain": {
      "3": "t_door_makeshift_c",
      "1": "t_palisade",
      "!": "t_pit_spiked",
      "-": "t_wall_log",
      "|": "t_wall_log",
      "#": "t_dirtfloor_thatchroof",
      "o": "t_dirtfloor_thatchroof",
      "B": "t_dirtfloor_thatchroof",
      "=": "t_dirtfloor_thatchroof",
      "I": "t_rock_wall_half",
      ".": "t_dirt"
    },
    "items": {
      "U": { "item": "hollow_village_foodstuffs", "repeat": [ 1, 3 ], "chance": 80 },
      "=": { "item": "hollow_village_storage", "chance": 70, "repeat": [ 1, 3 ] }
    },
    "furniture": {
      "t": "f_logstool",
      "o": "f_firering",
      "O": "f_firering",
      "=": "f_rack_wood",
      "H": "f_smoking_rack",
	  "B": "f_hammock"
    }
  },
  {
    "id": "hollow_village_foodstuffs",
    "type": "item_group",
    "subtype": "collection",
    "on_overflow": "spill",
    "container-item": "bag_canvas",
    "entries": [
		{ "item": "sausage_wasteland", "count": [ 6, 10 ], "prob": 70 },
		{ "item": "honey_bottled", "count": [ 4, 8 ], "container-item": "clay_pot", "prob": 50 },
		{ "item": "meat_smoked", "count": [ 6, 10 ], "prob": 70 },
		{ "item": "water_clean", "count": [ 4, 8 ], "container-item": "clay_pot", "prob": 80 },
		{ "item": "fish_smoked", "count": [ 6, 10 ], "prob": 70 }
    ]
  },
  {
    "id": "hollow_village_storage",
    "type": "item_group",
    "subtype": "distribution",
    "entries": [
      { "group": "hollow_village_foodstuffs", "count-max": 3, "prob": 70 },
      { "item": "arrow_fire_hardened_fletched", "count-max": 5, "prob": 40 },
      { "item": "bone_knife", "prob": 40 },
      { "item": "clay_pot", "prob": 50 },
      { "item": "bowl_wood", "prob": 60 },
      { "item": "skewer_bone", "prob": 20 },
      { "item": "spear_wood", "prob": 10 },
	  { "item": "javelin", "prob": 10, "count-max": 8 }
    ]
  },
  {
    "type": "mapgen",
    "method": "json",
    "om_terrain": "hollow_village",
    "object": {
      "fill_ter": "t_dirt",
      "rows": [
        "111111111111111111111111",
        "1......................1",
        "1......................1",
        "1......................1",
        "1......................1",
        "1......................1",
        "1......................1",
        "1......................1",
        "1......................1",
        "1......................1",
        "1......................1",
        "1......................1",
        "1......................1",
        "1......................1",
        "1......................1",
        "1......................1",
        "1......................1",
        "1......................1",
        "1......................1",
        "1......................1",
        "1......................1",
        "1......................1",
        "1......................1",
        "1111111111...11111111111"
      ],
      "flags": [ "ERASE_ALL_BEFORE_PLACING_TERRAIN" ],
      "palettes": [ "hollow_village_palette" ],
      "place_nested": [ { "chunks": [ "hollow_village_interior" ], "x": 1, "y": 1 } ]
    }
  },
  {
    "type": "overmap_special",
    "id": "hollow_village",
    "overmaps": [ { "point": [ 0, 0, 0 ], "overmap": "hollow_village_north" } ],
    "locations": [ "wilderness" ],
    "city_distance": [ 20, -5 ],
    "city_sizes": [ 0, 13 ],
    "occurrences": [ 0, 2 ],
	  "spawns": { "group": "GROUP_HOLLOW_TRIBAL_WARPARTY", "population": [ 2, 6 ], "radius": [ 2, 10 ] }
  },
  {
    "type": "overmap_terrain",
    "id": [ "hollow_village" ],
    "name": "small village",
    "sym": "v",
    "color": "red",
    "see_cost": 6,
    "flags": [ "RISK_HIGH" ]
  }
]
